NO textures/stone.xpm
SO textures/more_stone.xpm
WE textures/again_stone.xpm
EA textures/another_stone.xpm
CD textures/door.xpm

C 10,50,250
F 120,120,100

        1111111111111111111111111
        10000000001100000000000S1
        1011000001110000000000001
        1001000000000000000000001
111111111011000001110000000000001
100000000011000001110111111111111
11110111111111011100000010001
11110111111111011101010010001
11000000110101011100000010001
10000000000000001100000010001
10000000000000001101010010001
110000011101010111110111100111
11110111 1110101 101111010001
11111111 1111111 11111111111111
1111
1
1
1
1
1
1
1
1
1
1
1
1
1
1
1
11
1
1
1
1
1
1
1
1
1111
1
1
1
1
1
1
1
1
1
1
1
1
1
1
1
11
1
1
1
1
1
1
1
11111
1
1
1
1
1
1
1
1
1
1
1
1
1
1
1
11
1
1
1
1
1
1
1
11111
1
1
1
1
1
1
1
1
1
1
1
1
1
1
1
11
1
1
1
1
1
1
1
11111
1
1
1
1
1
1
1
1
1
1
1
1
1
1
1
1
