NO textures/wall_north.xpm
SO textures/wall_south.xpm
WE textures/wall_west.xpm
EA textures/wall_east.xpm
CD textures/door.xpm


F 1,1,1
C 10,10,100

11111111111111111111111111111111111
        100100000000000000000000W1
111111111011000001110000000000001
1000000000110000011101111D1111111
11110111111111011100000010001
11110111111111011101010010001
11000000110101011100000010001
10000111111000001100000010001
10000DDDDDD000001101010010001
110001111111010111110111100111
11110111 1110101 101111010001
11111111 1111111 11111111111111111111
